154
8
32 33 0 33 0 33 0 0 0 0 0 0 0 0 0 0 0 0 0 0 0 0 0 0 0 0 0 0 0 0 0 0 0 0 0 0 0 0 0 0 0 0 0 0 0 0 0 0 0 0 0 0 0 0 0 0 0 0 0 0 0 0 0 0 0 0 0 0 0 0 0 0 0 0 0 0 0 0 0 0 0 0 0 0 0 0 0 0 0 0 0 0 0 0 0 0 0 0 0 0 32 32 32 32 32 32 32 32 32 32 32 32 32 32 32 32 0 0 3 33 4 0 0 0 0 0 0 0 0 0 0 32 32 32 32 32 32 0 0 0 0 0 0 0 0 3 33 34 33 34 33 4 32 31 
32 38 0 37 0 37 0 0 0 0 0 0 0 0 0 0 0 0 0 0 0 0 0 0 0 0 0 0 0 0 0 0 0 0 0 0 0 0 0 0 0 0 0 0 0 0 0 0 0 0 0 0 0 0 0 0 0 0 0 0 0 0 0 0 0 0 0 0 0 0 0 0 0 0 0 0 0 0 0 0 0 0 0 0 0 0 0 0 0 0 0 0 0 0 0 0 0 0 0 0 0 32 32 32 32 32 32 32 32 32 32 32 32 32 32 32 0 0 0 0 0 0 0 0 0 0 0 0 0 0 0 0 32 32 32 32 32 0 0 0 0 0 0 0 0 0 37 0 37 0 37 0 32 32 
32 37 0 38 0 37 0 0 0 0 0 0 0 0 0 0 0 0 0 0 0 0 0 0 0 0 0 0 0 0 0 0 0 0 0 0 0 0 0 0 0 0 0 0 0 0 0 0 0 0 0 0 0 0 0 0 0 0 0 0 0 0 0 0 0 0 0 0 0 0 0 0 0 0 0 0 0 0 0 0 0 0 0 0 0 0 0 0 0 0 0 0 0 0 0 0 0 0 0 0 0 0 32 32 32 32 32 32 32 32 32 32 32 32 32 32 0 0 0 0 0 0 0 0 0 0 0 0 0 0 0 0 0 32 32 32 32 0 0 0 0 0 0 0 0 0 37 0 38 0 37 0 32 31 
32 37 0 37 0 38 0 0 0 0 0 0 0 0 0 0 0 0 0 0 0 0 32 32 32 32 0 0 0 0 0 32 0 0 0 0 0 0 0 0 0 0 0 0 0 32 32 32 0 0 0 0 0 0 0 0 0 0 0 0 0 0 0 0 0 0 0 0 0 0 0 0 0 0 0 0 0 0 0 0 0 0 0 0 0 0 0 0 0 0 0 0 0 0 0 0 0 0 0 0 0 0 0 0 0 0 0 0 0 0 0 0 0 0 0 0 0 0 0 0 0 0 0 0 0 0 0 0 0 0 0 0 0 0 32 32 32 0 0 0 0 0 0 0 0 0 37 0 37 0 38 0 32 32 
32 38 0 38 0 37 0 0 0 0 0 0 0 0 0 0 32 32 32 0 0 0 32 31 31 32 0 0 0 0 0 32 0 0 0 0 0 0 0 0 0 0 0 0 0 32 31 32 32 0 0 0 0 0 0 0 0 0 0 0 0 0 0 0 0 0 0 0 0 0 0 32 32 32 32 32 32 32 32 32 32 32 0 0 0 0 0 0 0 0 0 0 0 0 0 0 0 0 0 0 0 0 0 0 0 0 0 0 0 0 0 0 0 0 0 0 0 0 0 0 0 0 0 0 38 0 0 0 0 32 32 0 0 0 0 0 0 0 0 0 0 0 0 0 0 0 37 0 37 0 37 0 32 31 
32 37 0 37 0 38 0 0 0 0 0 0 0 0 0 32 32 32 32 0 0 0 32 31 31 32 0 0 0 0 32 32 0 0 0 0 0 0 0 0 0 0 0 0 0 32 32 31 32 32 0 0 0 0 0 0 0 0 0 0 0 0 0 0 0 0 0 0 0 0 32 32 31 32 32 31 32 32 31 32 32 32 32 0 0 0 0 0 0 0 0 0 0 0 32 32 32 0 0 0 0 0 0 0 0 0 0 0 0 0 0 0 0 0 0 0 0 0 0 38 0 0 0 0 37 0 0 0 0 32 32 32 0 0 0 0 0 0 0 0 0 0 0 0 0 0 38 0 37 0 37 0 32 32 
32 36 0 36 0 36 0 0 0 0 0 0 0 0 32 32 32 32 32 0 0 0 32 31 31 32 0 0 32 32 30 32 0 0 0 0 3 33 34 33 4 0 0 0 0 32 32 32 31 32 32 0 0 0 0 0 0 0 0 0 0 0 0 0 0 0 0 0 0 32 32 32 32 32 32 32 32 32 32 32 32 32 32 32 32 0 0 0 3 33 33 4 0 0 32 30 32 0 0 0 32 0 0 0 0 0 0 0 0 0 0 0 0 0 0 0 0 0 0 37 0 0 0 0 37 0 0 0 0 32 32 32 32 0 0 0 0 0 0 0 0 0 0 0 0 0 36 0 36 0 36 0 32 31 
34 33 34 33 34 33 34 33 34 33 34 33 34 32 32 32 32 32 32 0 0 0 32 31 31 32 0 0 32 30 32 32 0 0 0 0 0 35 0 35 0 0 0 0 0 32 32 32 32 31 32 32 32 32 32 32 32 32 32 32 32 32 32 32 32 32 32 32 32 32 30 32 32 30 32 32 30 32 32 30 32 32 30 32 32 0 0 0 0 35 35 0 0 0 32 32 32 0 0 0 32 32 32 32 32 32 32 32 32 32 32 32 32 32 32 32 0 0 0 37 0 0 0 0 37 0 0 0 0 32 32 32 32 32 32 32 32 32 32 32 32 32 32 32 32 32 32 32 32 32 32 32 32 32 
