132
8
31 31 33 34 33 34 33 4 0 0 0 0 0 0 0 0 0 0 0 0 0 0 0 0 0 0 0 0 0 0 0 0 0 0 0 0 0 0 0 0 0 0 0 0 0 0 0 0 0 0 0 0 0 0 0 0 0 0 0 0 0 0 0 0 0 0 0 0 0 0 0 0 0 0 0 0 0 0 0 0 0 0 33 0 0 0 0 0 0 0 0 0 0 0 0 0 0 0 0 0 0 0 0 0 0 0 0 0 0 0 0 0 0 0 0 36 0 0 0 0 0 0 0 0 0 37 37 37 31 30 30 31 
32 32 37 0 38 0 37 0 0 0 0 0 0 0 0 0 0 0 0 0 0 0 0 0 0 0 0 0 0 0 0 0 0 0 0 0 0 0 0 0 0 0 0 0 0 0 0 0 0 0 0 0 0 0 0 0 0 0 0 0 0 0 0 0 0 0 0 0 0 0 0 0 0 0 0 0 0 0 0 0 0 0 35 0 0 0 0 0 0 0 0 0 0 0 0 0 0 0 0 0 0 0 0 0 0 0 0 0 0 0 0 0 0 0 0 33 0 0 0 0 0 0 0 0 0 37 37 37 32 31 32 32 
30 31 37 0 37 0 37 0 0 0 0 0 0 0 0 0 0 0 0 0 0 0 0 0 0 0 0 0 32 30 30 32 0 0 0 0 0 0 0 0 0 0 0 0 0 0 0 0 0 0 0 0 0 0 0 0 0 0 0 0 0 0 0 0 0 0 0 35 0 0 0 0 0 0 0 0 0 0 0 0 0 0 35 0 0 0 0 0 0 0 0 0 0 0 0 0 0 0 0 0 0 0 0 0 0 0 0 0 0 0 0 0 0 0 0 35 0 0 0 0 0 0 0 0 0 37 37 37 32 30 32 30 
30 32 38 0 37 0 37 0 0 0 0 0 0 0 0 0 0 0 0 0 0 0 0 0 0 0 0 0 30 31 32 32 32 0 0 0 0 0 0 0 0 0 0 0 0 0 0 0 0 0 0 0 0 0 0 0 0 0 0 0 0 0 0 35 0 0 0 35 0 0 0 0 0 0 0 0 0 0 0 0 0 0 0 0 0 0 0 0 0 0 0 0 0 0 0 0 0 0 0 0 0 0 0 0 0 0 35 0 0 0 0 0 0 0 0 0 0 0 0 0 0 0 0 0 0 37 37 37 31 30 32 32 
31 30 37 0 37 0 37 0 0 0 0 0 0 0 0 0 0 0 0 0 0 0 0 0 0 0 0 0 32 30 32 32 32 31 31 0 0 0 0 0 0 0 0 0 0 0 0 0 0 0 0 0 0 0 0 0 0 0 0 0 0 0 0 35 0 0 0 35 0 0 3 33 34 33 4 0 0 0 38 0 0 0 0 0 0 0 0 0 0 0 0 0 0 0 0 0 0 0 0 0 0 0 0 0 0 0 35 0 0 0 0 35 0 0 0 0 0 0 0 0 0 0 0 0 0 36 36 36 31 32 32 32 
31 32 37 0 37 0 38 0 0 0 0 0 0 0 0 0 30 32 0 0 0 0 0 0 0 33 34 33 31 32 30 30 30 30 32 31 0 0 0 0 0 0 0 0 0 0 0 0 0 0 0 31 32 31 34 34 33 34 33 4 0 0 0 35 0 0 0 35 0 0 0 37 0 37 0 0 0 0 37 0 0 0 0 0 0 0 0 0 3 33 34 32 32 32 32 0 0 0 0 0 0 0 38 0 0 3 33 4 0 0 0 35 0 0 0 0 0 32 32 32 32 32 32 31 32 30 32 32 32 32 31 32 
30 30 36 0 36 0 36 0 0 0 0 0 0 0 0 31 31 30 0 0 0 0 0 0 0 35 0 35 30 31 32 30 32 31 32 32 31 31 30 32 31 32 32 30 32 30 32 32 31 31 31 32 31 30 30 31 35 0 35 0 0 0 0 35 0 0 0 35 0 0 0 37 0 37 0 0 0 0 37 0 0 0 38 0 0 0 0 0 0 35 0 32 32 30 32 31 30 32 32 30 31 32 36 0 0 0 35 0 0 0 3 33 4 0 0 0 0 32 32 32 32 31 30 31 32 30 31 32 30 31 30 32 
32 31 40 34 33 34 33 34 33 34 33 34 33 39 31 30 32 30 0 0 33 33 0 0 0 35 0 35 32 31 32 30 30 32 32 31 31 30 30 32 30 32 31 32 30 32 31 30 31 32 31 32 30 31 31 32 32 0 35 0 0 0 0 35 0 0 0 35 0 0 0 37 0 37 0 0 0 0 37 0 0 0 36 0 0 0 0 0 0 35 0 30 31 32 32 31 32 32 30 32 30 32 32 32 32 32 35 0 0 0 0 35 0 0 0 0 0 32 30 32 31 31 32 32 31 32 30 32 32 30 32 31 
